---1---1---1-----2
11111-----2-2----1
22-1-2----1-333--3
11111-----2-2----1
---1---1---1-----2