--3----2--3-23-
---------3-----
4--------------
---------3-----
--3----2--3-23-