3-----3-----3----4
---3----4------3--
4----3---3---33--3
---3----4------3--
3-----3-----3----4