1-22-2-3------1
--2-1--23-3-2-2
3---31--2-3---0
--2-1--23-3---1
1-22-2-3--3-2-2